一一	gggg
一个	ggwh
一个	ggwh
一会	ggwf
一束	gggk
一样	ggsu
一段	ggwd
一直	ggfh
一直	ggfh
一致	gggc
一般	ggte
一说	ggyu
丁雪	sgfv
七个	agwh
万丹	gqmy
三个	dgwh
三周	dgmf
三维	dgxw
下周	ghmf
下图	ghlt
下载	ghfl
专业	fnog
专享	fnyk
专治	fnic
世纪	anxn
业绩	ogxg
东湖	aiid
东西	aisg
两个	gmwh
两周	gmmf
中午	khtf
中华	khwx
中国	khlg
中央	khmd
中文	khyy
中通	khce
主要	ygsv
么么	tctc
么么	tctc
之前	ppue
之后	pprg
之外	ppqh
九个	vtwh
习惯	nunx
买的	nurq
了解	bnqe
事情	gkng
二个	fgwh
二爹	fgwr
互相	gxsh
五个	ggwh
五年	ggrh
五条	ggts
五笔	ggtt
交互	ywgx
产品	utkk
产物	uttq
京东	ykai
亲你	uswq
亲手	usrt
人家	wwpg
人工	wwaa
什么	wftc
今天	wygd
今天	wygd
今年	wyrh
今年	wyrh
从中	wwkh
他们	wbwu
他会	wbwf
他妹	wbvf
他找	wbra
他说	wbyu
付钱	wfqf
代码	wadc
代表	wage
代谢	wayt
以前	nyue
以及	nyby
价值	wwwf
价格	wwst
任何	wtws
任意	wtuj
休息	wsth
休眠	wshn
优先	wdtf
优化	wdwx
优点	wdhk
会下	wfgh
会去	wffc
会玩	wfgf
会的	wfrq
会说	wfyu
传出	wfbm
估计	wdyf
但是	wjjg
低低	wqwq
低沉	wqip
佐证	wdyg
体内	wsmw
余额	wgpt
作为	wtyt
作用	wteh
作者	wtft
你们	wqwu
你会	wqwf
你先	wqtf
你在	wqdh
你好	wqvb
你就	wqyk
你是	wqjg
你是	wqjg
你来	wqgo
你说	wqyu
使之	wgpp
使得	wgtj
使用	wgeh
例如	wgvk
例子	wgbb
供能	wace
依据	wyrn
依然	wyqd
侧链	wmql
便宜	wgpe
保存	wkdh
保证	wkyg
信息	wyth
修复	whtj
修改	whnt
假如	wnvk
催化	wmwx
元组	fqxe
充分	ycwv
先前	tfue
先导	tfnf
光山	igmm
光盘	igte
光驱	igcg
全国	wglg
全部	wguk
八个	wtwh
六个	ywwh
共赢	awyn
关了	udbn
关于	udgf
关心	udny
关机	udsw
关系	udtx
关联	udbu
关键	udqv
其中	adkh
其它	adpx
其实	adpu
具体	hwws
内容	mwpw
冯敏	uctx
冯盼	uchw
决定	unpg
冻着	uaug
准备	uwtl
准确	uwdq
凌日	ufda
凌旭	ufvj
减少	udit
减轻	udlc
减速	udgk
几乎	wttu
几次	wtuq
几点	wthk
出发	bmnt
出来	bmgo
出水	bmii
出现	bmgm
函数	biov
分别	wvke
分子	wvbb
分数	wvov
分析	wvsr
分类	wvod
分配	wvsg
刘倩	yjwg
刘双	yjcc
刘君	yjvt
刘影	yjjy
刘琛	yjgp
刘聪	yjbu
刘辉	yjig
刘进	yjfj
刘鑫	yjqq
刘飞	yjnu
刘香	yjtj
刚才	mrft
刚来	mrgo
初始	puvc
删除	mmbw
判定	ugpg
判断	ugon
利用	tjeh
别人	keww
别名	keqk
刷新	nmus
前人	ueww
前天	uegd
前年	uerh
前景	uejy
前面	uedm
力场	enfn
功能	aece
加上	ekhg
加入	ekty
加氢	ekrn
加速	ekgk
动态	fcdy
包含	qnwy
包括	qnrt
化合	wxwg
化学	wxip
北京	uxyk
匹配	aqsg
区别	arke
医学	atip
十个	fgwh
升级	taxb
华为	wxyt
华科	wxtu
单晶	uljj
南山	fmmm
博士	fgfg
卡扣	hgrk
卡片	hgth
卢方	hnyy
卢超	hnfh
印度	qgoa
危房	qdyn
历年	derh
原因	drld
原来	drgo
原理	drgj
去年	fcrh
去年	fcrh
去年	fcrh
去拿	fcwg
去掉	fcrh
去看	fcrh
参与	cdgn
参考	cdft
反向	rctm
反应	rcoi
反悔	rcnt
反馈	rcqn
发现	ntgm
发生	nttg
发表	ntge
取名	bcqk
变成	yodn
变量	yojg
另外	keqh
只有	kwde
可以	skny
可汗	skif
可能	skce
可视	skpy
可逆	skub
右上	dkhg
右下	dkgh
右边	dkep
号线	kgxf
合成	wgdn
合理	wggj
同学	mgip
同意	mguj
同时	mgjf
名字	qkpb
名称	qktq
后台	rgck
后天	rggd
后盖	rgug
后面	rgdm
向芳	tmay
含有	wyde
启动	ynfc
吴丹	kgmy
吴玲	kggw
吴蕊	kgan
吴鑫	kgqq
吸取	kbbc
周一	mfgg
周三	mfdg
周丽	mfgm
周二	mffg
周五	mfgg
周六	mfyw
周四	mflh
周日	mfda
周羽	mfnn
周轶	mflr
周高	mfyk
呼呼	ktkt
命令	wgwy
品牌	kkth
哈哈	kwkw
哪个	knwh
哪些	knhx
哪件	knwt
哪儿	knqt
哪里	knjf
唐为	ovyt
唯一	kwgg
啥啊	kwkb
喜好	fkvb
喜欢	fkcq
嗯嗯	klkl
嘿嘿	klkl
四个	lhwh
四位	lhwu
四码	lhdc
回去	lkfc
回复	lktj
回调	lkym
因为	ldyt
因此	ldhx
困难	lscw
固定	ldpg
国际	lgbf
图们	ltwu
图像	ltwq
图标	ltsf
图片	ltth
在线	dhxf
地方	fbyy
坐船	wwte
垃圾	fufb
域名	faqk
基于	adgf
基因	adld
基础	addb
增加	fuek
处理	thgj
备份	tlww
复习	tjnu
复制	tjrm
复杂	tjvs
外网	qhmr
多个	qqwh
多些	qqhx
多多	qqqq
多大	qqdd
大便	ddwg
大型	ddga
大学	ddip
大家	ddpg
大概	ddsv
大碗	dddp
大量	ddjg
天津	gdiv
天然	gdqd
失效	rwyw
她们	vbwu
好久	vbqy
好了	vbbn
好像	vbwq
好吃	vbkt
好吧	vbkc
好好	vbvb
好点	vbhk
好用	vbeh
好的	vbrq
好胜	vbet
好评	vbyg
如下	vkgh
如何	vkws
如图	vklt
如果	vkjs
妈蛋	vcnh
妞妞	vnvn
妞妞	vnvn
姜程	ugtk
姨姥	vgvf
字体	pbws
字典	pbma
字根	pbsv
字段	pbwd
存储	dhwy
孙畅	bijh
孙雪	bifv
孤立	bruu
学习	ipnu
学堂	ipip
学姐	ipve
学学	ipip
学校	ipsy
学生	iptg
学院	ipbp
安装	pvuf
完全	pfwg
完善	pfug
官方	phyy
官网	phmr
定义	pgyr
定位	pgwu
定制	pgrm
宝宝	pgpg
实习	punu
实现	pugm
实验	pucg
审核	pjsy
容易	pwjq
宽大	padd
密码	pndc
密钥	pnqe
寝室	pupg
对于	cfgf
对应	cfoi
对象	cfqk
对齐	cfyj
寻找	vfra
导入	nfty
导师	nfjg
将来	uqgo
小米	ihoy
尝试	ipya
就业	ykog
就是	ykjg
尼玛	nxgc
尼玛	nxgc
尽快	nynn
屌丝	nkxx
屏幕	nuaj
崔宝	mwpg
崔斌	mwyf
工业	aaog
工作	aawt
工具	aahw
工程	aatk
工资	aauq
左上	dahg
左上	dahg
已有	nnde
已知	nntd
已经	nnxc
布局	dmnn
师兄	jgkq
师姐	jgve
带个	gkwh
带你	gkwq
带来	gkgo
帮你	dtwq
帮你	dtwq
帮我	dttr
常用	ipeh
常见	ipmq
常规	ipfw
幕布	ajdm
干嘛	fgko
干旱	fgjf
平台	guck
平安	gupv
平时	gujf
并且	uaeg
广泛	oyit
应用	oieh
应聘	oibm
应该	oiyy
底物	oqtq
底物	oqtq
康凯	ovmn
延吉	thfk
延边	thep
建立	vguu
建议	vgyy
建隆	vgbt
开发	gant
开启	gayn
开始	gavc
开机	gasw
异构	nasq
弄了	gabn
引号	xhkg
张丽	xtgm
张云	xtfc
张俊	xtwc
张卓	xthj
张娟	xtvk
张婵	xtvu
张强	xtxk
张旭	xtvj
张源	xtid
张溪	xtie
张琪	xtga
张硕	xtdd
张艳	xtdh
张蕊	xtan
张钊	xtqj
张雨	xtfg
张龙	xtdx
强大	xkdd
当作	ivwt
当回	ivlk
当时	ivjf
当然	ivqd
彩打	esrs
彭辉	fkig
影响	jykt
很多	tvqq
徐明	twje
得到	tjgc
微信	tmwy
微博	tmfg
必须	nted
忙完	nypf
忠县	kheg
快充	nnyc
快慢	nnnj
快速	nngk
怎么	thtc
怎样	thsu
性能	ntce
总结	ukxf
恢复	ndtj
您好	wqvb
情况	nguk
情形	ngga
想你	shwq
想要	shsv
意义	ujyr
意思	ujln
感觉	dgip
感谢	dgyt
戏弄	caga
成功	dnae
我们	trwu
我去	trfc
我都	trft
我问	truk
或者	akft
所以	rnny
所有	rnde
所示	rnfi
手工	rtaa
手机	rtsw
手段	rtwd
才吃	ftkt
才是	ftjg
才来	ftgo
打开	rsga
执行	rvtg
扫过	rvfp
扫过	rvfp
找出	rabm
找到	ragc
把我	rctr
折成	rrdn
折腾	rreu
抢到	rwgc
报错	rbqa
披露	rhfk
抱抱	rqrq
抱歉	rquv
抹布	rgdm
抽中	rmkh
拆分	rrwv
拆字	rrpb
拉勾	ruqc
拌饭	ruqn
拼音	ruuj
拿去	wgfc
指定	rxpg
指导	rxnf
指纹	rxxy
按照	rpjv
挑战	rqhk
挖掘	rprn
换成	rqdn
排列	rhgq
排在	rhdh
排好	rhvb
排序	rhoc
排版	rhth
探索	rpfp
接口	rukk
接着	ruug
描红	raxa
提供	rjwa
提出	rjbm
提到	rjgc
提前	rjue
提取	rjbc
提醒	rjsg
提问	rjuk
提高	rjyk
插件	rtwt
搜狗	reqt
搜索	refp
搞定	rypg
搬砖	rtdf
搭配	rasg
撤回	rylk
操作	rkwt
支持	fcrf
收到	nhgc
收工	nhaa
收货	nhwx
改进	ntfj
效果	ywjs
教学	ftip
教程	fttk
数学	ovip
数据	ovrn
整个	gkwh
整体	gkws
整合	gkwg
整理	gkgj
文件	yywt
文件	yywt
文员	yykm
文字	yypb
文献	yyfm
断开	onga
断流	oniy
新闻	usub
新颖	usxt
方便	yywg
方式	yyaa
方案	yypv
方法	yyif
方程	yytk
方面	yydm
无效	fqyw
早点	jfhk
时候	jfwh
时间	jfuj
明天	jegd
明天	jegd
明年	jerh
明白	jerr
易信	jqwy
易浩	jqit
易迅	jqnf
昨天	jtgd
显瘦	joue
显示	jofi
显著	joaf
晚饭	jqqn
普通	uoce
暖男	jele
更多	gjqq
更新	gjus
更正	gjgh
曹硕	gmdd
曾哥	ulsk
曾虎	ulha
最优	jbwd
最后	jbrg
最大	jbdd
最好	jbvb
最新	jbus
最爱	jbep
最短	jbtd
最终	jbxt
最近	jbrp
月底	eeoq
有时	dejf
有缘	dexx
有谁	deyw
有道	deut
期末	adgs
期间	aduj
未知	fitd
本机	sgsw
朱贺	riek
朱露	rifk
机会	swwf
机制	swrm
权重	sctg
权限	scbv
李夏	sbdh
李娜	sbvn
李婷	sbvy
李建	sbvg
李拼	sbru
李文	sbyy
李方	sbyy
李昱	sbju
李曹	sbgm
李楠	sbsf
李渊	sbit
李燕	sbak
李言	sbyy
李辉	sbig
李霖	sbfs
李龙	sbdx
来信	gowy
来啦	gokr
来着	goug
杨啸	snkv
杨梦	snss
杨欢	sncq
杨鑫	snqq
松江	swia
构象	sqqk
查查	sjsj
查询	sjyq
标准	sfuw
校友	sydc
根据	svrn
检查	swsj
检索	swfp
模型	saga
樱花	smaw
次数	uqov
次要	uqsv
正则	ghmj
正在	ghdh
正常	ghip
正确	ghdq
此种	hxtk
步长	hhta
武大	fhdd
武大	fhdd
武汉	fhic
残基	gqad
殷如	rvvk
每个	txwh
每次	txuq
比如	xxvk
比较	xxly
毕业	xxog
永久	ynqy
求知	gitd
江涛	iaid
汪亮	igyk
没了	iwbn
没事	iwgk
没事	iwgk
没呢	iwkn
没有	iwde
没用	iweh
没空	iwpw
河健	iswv
泡脚	iqef
波及	ihby
注册	iymm
洗洗	itit
流畅	iyjh
流程	iytk
流量	iyjg
浅水	ifii
浅蓝	ifaj
测试	imya
浏览	iyjt
涂敏	iwtx
涂新	iwus
涂玲	iwgw
涂琴	iwgg
涂超	iwfh
消息	iith
涉及	ihby
淘宝	iqpg
淤积	iytk
添加	igek
清楚	igss
清理	iggj
清空	igpw
清胃	igle
满意	iauj
满满	iaia
漂亮	isyk
漏掉	inrh
潜力	ifen
潜能	ifce
炒粉	oiow
点击	hkgb
烧糊	oaod
然后	qdrg
燃料	oqou
片断	thon
片段	thwd
牛人	tgww
物质	tqrf
特定	tfpg
特色	tfqc
独特	qttf
猎豹	qteq
猜想	qtsh
王凯	ggmn
王哲	ggrr
王婷	ggvy
王嫡	ggvy
王微	ggtm
王曼	ggjl
王涛	ggid
王爽	ggdr
王码	ggdc
王超	ggfh
王闪	gguw
王雪	ggfv
现在	gmdh
现场	gmfn
现状	gmud
珞珈	gtge
理发	gjnt
甚至	adgc
生产	tgut
生化	tgwx
生命	tgwg
生成	tgdn
生效	tgyw
生物	tgtq
生说	tgyu
用些	ehhx
用以	ehny
用到	ehgc
用户	ehyn
用来	ehgo
田波	llih
田雪	llfv
由于	mhgf
电子	jnbb
电脑	jney
电话	jnyt
男的	lerq
疾病	utug
登陆	wgbg
白洋	rriu
白爽	rrdr
百度	djoa
百度	djoa
的话	rqyt
皮肤	hcef
目前	hhue
目录	hhvi
目标	hhsf
直接	fhru
相互	shgx
相似	shwn
相信	shwy
相关	shud
相加	shek
相对	shcf
看啥	rhkw
看来	rhgo
真心	fhny
真的	fhrq
真绝	fhxq
真题	fhjg
真题	fhjg
知识	tdyk
知道	tdut
短信	tdwy
码表	dcge
研究	dgpw
破解	dhqe
硬盘	dgte
硬着	dgug
确诊	dqyw
磨砂	osdi
神功	pyae
神奇	pyds
禁止	sshh
离校	yrsy
科学	tuip
秒杀	tirs
称之	tqpp
移除	tqbw
程周	tkmf
程哥	tksk
程序	tkoc
程明	tkje
稳定	tqpg
空港	pwia
空白	pwrr
空闲	pwus
空间	pwuj
突然	pwqd
立体	uuws
立即	uuvc
章颖	ujxt
符合	twwg
等待	tftf
等我	tftr
答疑	twxt
答辩	twud
简介	tuwj
简单	tuul
简直	tufh
简码	tudc
简章	tuuj
简约	tuxq
算了	thbn
算法	thif
米线	oyxf
类似	odwn
精准	oguw
精心	ogny
精灵	ogvo
系统	txxy
索引	fpxh
繁多	txqq
红色	xaqc
纪录	xnvi
纪楠	xnsf
线程	xftk
练车	xalg
组会	xewf
经过	xcfp
经验	xccg
结束	xfgk
结构	xfsq
结果	xfjs
结论	xfyw
绕过	xafp
绘制	xwrm
给出	xwbm
给定	xwpg
统一	xygg
统计	xyyf
绪论	xfyw
续费	xfxj
绳缆	xkxj
绿色	xvqc
编写	xypg
编号	xykg
编码	xydc
编译	xyyc
编辑	xylk
缩写	xppg
网上	mrhg
网卡	mrhg
网址	mrfh
网站	mruh
网络	mrxt
网银	mrqv
网页	mrdm
罗陈	lqba
美化	ugwx
美美	ugug
美观	ugcm
翻译	toyc
老家	ftpg
老师	ftjg
老是	ftjg
考上	fthg
考博	ftfg
考研	ftdg
考虑	ftha
考试	ftya
而且	dmeg
而言	dmyy
耗时	dijf
联系	butx
联网	bumr
肥牛	ectg
肯定	hepg
胡伟	dewf
能到	cegc
能力	ceen
脐带	eygk
脚本	efsg
自动	thfc
自己	thnn
自带	thgk
自建	thvg
舒兵	wfrg
节点	abhk
花呗	awkm
苏宁	aeps
英才	amft
苹果	agjs
荣玉	apgy
药物	axtq
药理	axgj
莲子	albb
获取	aqbc
萜类	amod
董媛	atve
蓝色	ajqc
薛娇	awvt
虚拟	harn
虽然	kjqd
蛋白	nhrr
融合	gkwg
血糖	tloo
行不	tgdh
行么	tgtc
行吧	tgkc
行啊	tgkb
行将	tguq
补充	puyc
表嫂	geve
表明	geje
表格	gest
表示	gefi
表述	gesy
袁乐	fktn
袋子	wabb
袖子	pubb
装饰	ufqn
西藏	sgad
要求	svgi
覆盖	stug
见着	mqug
规模	fwsa
视频	pyhh
觉得	iptj
解决	qeun
解释	qeto
触宝	qepg
计费	yfxj
认为	ywyt
认真	ywfh
讨论	yfyw
论坛	ywff
设定	ywpg
设置	ywlf
设计	ywyf
访问	yyuk
识别	ykke
词库	ynol
词组	ynxe
试了	yabn
试用	yaeh
试试	yaya
详情	yung
详细	yuxl
语音	yguj
语音	yguj
误会	ykwf
说明	yuje
说是	yujg
说的	yurq
说着	yuug
请问	yguk
读书	yfnn
调剂	ymyj
调整	ymgk
调用	ymeh
调研	ymdg
调频	ymhh
谈弋	yoay
谢谢	ytyt
谭阳	ysbj
谷歌	wwsk
负担	qmrj
资料	uqou
资源	uqid
赤壁	fonk
起亚	fhgo
超市	fhym
超过	fhfp
足够	khqk
跑男	khle
路径	khtc
跳转	khlf
车通	lgce
转动	lffc
转化	lfwx
转换	lfrq
转移	lftq
轮渡	lwio
软件	lqwt
轻松	lcsw
输入	lwty
输出	lwbm
辛苦	ufad
达到	dpgc
迅雷	nffl
过来	fpgo
过程	fptk
过节	fpab
运行	fctg
近些	rphx
还得	dhtj
还是	dhjg
还是	dhjg
还有	dhde
还算	dhth
还要	dhsv
还说	dhyu
这样	ypsu
进入	fjty
进去	fjfc
进行	fjtg
远程	fqtk
连接	lpru
迫切	rpav
迭代	rwwa
退寝	vepu
送你	udwq
适合	tdwg
选定	tfpg
选择	tfrc
选错	tfqa
选项	tfad
透明	tbje
途径	wgtc
通常	ceip
通知	cetd
通路	cekh
通过	cefp
逛完	qtpf
速度	gkoa
造词	tfyn
遇到	jmgc
邓喆	cbfk
那个	ngwh
那么	ngtc
那儿	ngqt
那可	ngsk
那样	ngsu
邮件	mbwt
邮寄	mbpd
邮箱	mbts
邹李	qvsb
郑兴	udig
郑华	udwx
郑艳	uddh
部分	ukwv
郭超	ykfh
配体	sgws
配置	sglf
配色	sgqc
酱汤	uqin
酶号	sgkg
里面	jfdm
重启	tgyn
重启	tgyn
重复	tgtj
重新	tgus
重要	tgsv
金妍	qqvg
金日	qqda
链接	qlru
锁屏	qinu
锁门	qiuy
错误	qayk
长度	taoa
门窗	uypw
问题	ukjg
阿里	bsjf
阿里	bsjf
陈伟	bawf
陈康	baov
陈惠	bagj
陈栋	basa
陈浩	bait
陈涛	baid
陈群	bavt
陈虎	baha
陈进	bafj
除非	bwhd
陶慧	bqdh
随意	bduj
难以	cwny
难道	cwut
难题	cwjg
集合	wywg
集成	wydn
雕凿	mfog
需求	fdgi
需要	fdsv
青天	gegd
非常	hdip
非得	hdtj
靶标	aksf
靶标	aksf
韩晶	fjjj
韩玲	fjgw
韩莹	fjap
韵达	ujdp
页面	dmdm
顶字	sdpb
项目	adhh
顺丰	kddh
顺序	kdoc
预测	cnim
预警	cnaq
领域	wyfa
频率	hhyx
频繁	hhtx
题典	jgma
题海	jgit
颜色	utqc
颜面	utdm
风格	wrst
风险	wrbw
飞信	nuwy
首页	utdm
马上	cghg
马飞	cgnu
驰骋	cgcg
驱动	cgfc
验证	cgyg
高中	ykkh
高德	yktf
高清	ykig
高阳	ykbj
魅族	rqyt
魅族	rqyt
鲍悦	qgnu
麻烦	osod
黄杰	amso
黄荣	amap
黄蓉	amap
黄酮	amsg
黄酮	amsg
黄靖	amug
黎寒	tqpa
黑夜	lfyw
黑白	lfrr
黑色	lfqc
默认	lfyw
一个月	gwee
丁二酸	sfsg
丁兵兵	srrg
丁国翠	slny
丁煜倬	sowh
丁邵珍	svgw
两块钱	gfqf
中国人	klww
中科院	ktbp
么么哒	ttkd
二合一	fwgg
二维码	fxdc
二面角	fdqe
云存储	fdwy
亚马逊	gcbi
人事部	wguk
人性化	wnwx
什么事	wtgk
他汀类	wiod
他没说	wiyu
付丹丹	wmmy
付名扬	wqrn
付智仲	wtwk
代金券	wqud
任何事	wwgk
任志强	wfxk
任梦梦	wsss
伊斯特	watf
低密度	wpoa
何玉贤	wgjc
余伟江	wwia
余舒琪	wwga
余鹏鹏	weee
侯晓沛	wjig
保税区	wtar
做网站	wmuh
充电器	yjkk
充电宝	yjpg
充话费	yyxj
公交卡	wyhg
农科所	ptrn
冯世伦	uaww
冯世兴	uaig
准确率	udyx
几分钟	wwqk
出发地	bnfb
函数名	boqk
分辨率	wuyx
刑佳钰	gwqg
刘义胜	yyet
刘凤娇	ywvt
刘嘉睿	yfhp
刘天罡	yglg
刘婷婷	yvvy
刘家春	ypdw
刘家民	ypna
刘艳萍	ydai
别这样	kysu
剪不断	udon
动力学	feip
包翠香	qntj
化合物	wwtq
化合物	wwtq
化学品	wikk
医学部	aiuk
升学宴	tipj
单分子	uwbb
单田芳	ulay
南宗焕	fpoq
卢盈旋	hbyt
历小丹	dimy
原瑞凯	dgmn
去哪儿	fkqt
双系统	ctxy
反人类	rwod
取现金	bgqq
叠加包	ceqn
可视化	spwx
史敦海	kyit
叶青林	kgss
向倩榕	twsp
向曙光	tjig
吕惠子	kgbb
吕振斌	kryf
吕文兴	kyig
吴凤意	kwuj
吴师文	kjyy
吴玉兰	kgud
吴知非	kthd
周六日	myda
周婷兰	mvud
周尤涛	mdid
周海庆	miod
周自平	mtgu
呵呵呵	kkks
唐保志	owfn
唐永林	oyss
唐永虎	oyha
回去了	lfbn
回学校	lisy
坐公交	wwyw
坐地铁	wfqr
坐火车	wolg
处理器	tgkk
复合物	twtq
夏凯丽	dmgm
夏思宇	dlpg
夏桂权	dssc
多态性	qdnt
大数据	dorn
天通苑	gcaq
女博士	vffg
好东西	vasg
姚鹏飞	venu
娄兰兰	ouud
娄权利	ostj
孙卫平	bbgu
孙宇辉	bpig
孙文婷	byvy
孙文超	byfh
孙良鹏	byee
孙金凤	bqwc
孟会影	bwjy
学电脑	ijey
安英珍	pagw
宋雪萍	pfai
官绪超	pxfh
宝贝儿	pmqt
实验室	pcpg
审核人	psww
审核员	pskm
宿子瑶	pbge
小木虫	isjh
小狼毫	iqyk
尹丽丽	vggm
屎尿屁	nnnx
岑毅虹	muja
崔瑜娜	mgvn
崔银姬	mqva
崔龙成	mddn
工学部	aiuk
年轻人	rlww
廖雪峰	ofmt
开发者	gnft
开心的	gnrq
开玩笑	ggtt
弄一下	gggh
张亚楠	xgsf
张天丽	xggm
张宇宁	xpps
张宇琛	xpgp
张宗运	xpfc
张帅军	xjpl
张庆涛	xoid
张建军	xvpl
张德全	xtwg
张志波	xfih
张思龙	xldx
张文慧	xydh
张晓波	xjih
张有亲	xdus
张松山	xsmm
张浩然	xiqd
张玉静	xgge
张皓然	xrqd
张紫鑫	xhqq
张红霞	xxfn
张维伯	xxwr
张钰京	xqyk
彭业成	fodn
彭洪才	fift
彭海东	fiai
彭琼玲	fggw
徐春光	tdig
徐润生	titg
微生物	tttq
怎么了	ttbn
怎么弄	ttga
性价比	nwxx
性生活	ntit
愚人节	jwab
手机号	rskg
扫一扫	rgrv
支付宝	fwpg
教师证	fjyg
数据库	orol
数据线	orxf
数据表	orge
文件夹	ywgu
文元西	yfsg
文师师	yjjg
新世纪	uaxn
方文山	yymm
易善勇	juce
易善德	jutf
易善维	juxw
易培松	jfsw
易明双	jjcc
易海祯	jipy
易老师	jfjg
曹小文	giyy
曹晓璇	gjgy
曹桂领	gswy
曹祎卉	gpfa
曾宪刚	upmr
曾龙龙	uddx
有问题	dujg
服务器	etkk
本科生	sttg
朱乾荣	rfap
朱倩倩	rwwg
朴光哲	sirr
朴曙东	sjai
朴海媛	sive
朴海星	sijt
杀下毒	rggx
李丹艳	smdh
李亚茹	sgav
李光辉	siig
李兴会	siwf
李勇健	scwv
李华清	swig
李园丽	slgm
李娜级	svxb
李媛媛	svve
李建鑫	svqq
李彩宾	sepr
李征远	stfq
李志勇	sfce
李愉晨	snjd
李明星	sjjt
李明洙	sjir
李晓珍	sjgw
李海静	sige
李燕飞	sanu
李琪琛	sggp
李胜青	sege
李花淑	saih
李苗苗	saal
李莲花	saaw
李萌萌	saaj
李银姬	sqva
李阳阳	sbbj
李顺治	skic
李鹏飞	senu
来这儿	gyqt
杨世凯	samn
杨凯婷	smvy
杨小燕	siak
杨春丽	sdgm
杨艳召	sdvk
杨贺然	seqd
林羽湉	snin
林雨湉	sfin
某一个	agwh
柚皮素	shgx
查看的	srrq
柳叶茂	skad
柳海燕	siak
梁家兴	ipig
模糊了	sobn
横坐标	swsf
正丁醇	gssg
正确率	gdyx
正确率	gdyx
武晓琳	fjgs
段贵批	wkrx
段越敏	wftx
段雪健	wfwv
比昨天	xjgd
比蜜蜡	xpja
比较全	xlwg
比较牛	xltg
氢原子	rdbb
池淏甜	iitd
池金花	iqaw
汪倩倩	iwwg
汪志桥	ifst
沈世信	iawy
没事儿	igqt
没明白	ijrr
涂伟忠	iwkh
涂伟忠	iwkh
涂培勇	ifce
涂培红	ifxa
涂太保	idwk
涂太平	idgu
涂安忠	ipkh
涂建功	ivae
涂敦平	iygu
涂敦民	iyna
涂登元	iwfq
涂继忠	ixkh
涂贵荣	ikap
温夏夏	iddh
滑板鞋	isak
滕梓臣	esah
滚床单	ioul
潘福军	ippl
潘诗逸	iyqk
熊彬彬	csss
熊念山	cwmm
爱奇艺	edan
爱宝宝	eppg
爱是个	ejwh
狼图腾	qleu
王丽丽	gggm
王乐乐	gttn
王亚娟	ggvk
王亚蓉	ggap
王伟伟	gwwf
王冬雪	gtfv
王剑坤	gwfj
王加丽	gegm
王卢莎	ghai
王国海	glit
王天阳	ggbj
王婷婷	gvvy
王嫒嫡	gvvy
王官正	gpgh
王建朝	gvfj
王志强	gfxk
王忠骞	gkpa
王恩民	glna
王才华	gfwx
王振亚	grgo
王晓丹	gjmy
王有为	gdyt
王洪鸣	gikq
王淇漫	giij
王爱荣	geap
王玉江	ggia
王田田	glll
王红妮	gxvn
王轶宙	glpm
王顺超	gkfh
王鹏宇	gepg
珞珈山	ggmm
生成器	tdkk
生科院	ttbp
用得上	ethg
田玉顺	lgkd
电子版	jbth
电脑版	jeth
白壹鹏	rfee
白小龙	ridx
百度云	dofc
盛倩文	dwyy
目的地	hrfb
真好看	fvrh
真没劲	fica
祁建钊	pvqj
秦亚红	dgxa
秦智亮	dtyk
移动号	tfkg
程功平	tagu
程晓燕	tjak
穆冠桥	tpst
经济区	xiar
续广娟	xovk
罗吉芳	lfay
罗容君	lpvt
罗惠善	lgug
羊肉煲	umwk
考驾照	fejv
耿文静	byge
联发科	bntu
联系人	btww
肖丽萍	igai
背单词	uuyn
胡宇浩	dpit
胡翠苹	dnag
胡老师	dfjg
胡黔楠	dlsf
脂蛋白	enrr
膜蛋白	enrr
自定义	tpyr
苏晓东	ajai
范德华	atwx
葛元洁	afif
葡萄糖	aaoo
虚拟机	hrsw
虞教练	hfxa
虞诗诚	hyyd
蛋白质	nrrf
行不行	tdtg
街道口	tukk
袁帅芳	fjay
袁淑华	fiwx
袁艳平	fdgu
解秋芳	qtay
计算机	ytsw
许仁政	ywgh
许佳佳	ywwf
许小文	yiyy
许立志	yufn
试一下	yggh
试一下	yggh
说一声	ygfn
请留言	yqyy
谢剑梅	ywst
谢周凡	ymwy
谢艳蕾	ydaf
谢顺岚	ykmw
财付通	mwce
财务科	mttu
贾平平	sggu
贾晓歌	sjsk
赖崇德	gmtf
赵俊凤	fwwc
赵兴月	fiee
赵潇溟	fiip
路路通	kkce
车伟健	lwwv
辅导班	lngy
输入人	ltww
输入员	ltkm
过拟合	frwg
过滤器	fikk
过生日	ftda
这三天	ydgd
连不上	ldhg
迟美娇	nuvt
迭代器	rwkk
逛一下	qggh
邓文文	cyyy
邓莎莎	caai
邢肖兰	giud
邹佳丽	qwgm
郑学兰	uiud
郑明善	ujug
郑春明	udje
郭衍良	ytyv
采购员	emkm
金丽丽	qggm
金丽华	qgwx
金光洙	qiir
金光浩	qiit
金晟宇	qjpg
金海旭	qivj
金玉善	qgug
金红花	qxaw
金练文	qxyy
金美娜	quvn
金老师	qfjg
金香子	qtbb
钟大猷	qdus
钱兵兵	qrrg
银行卡	qthg
长兴镇	tiqf
门秋序	utoc
闫秋瑾	utga
阮一峰	bgmt
阮昌应	bjoi
阿迪亚	bmgo
陈丽华	bgwx
陈佳欢	bwcq
陈全永	bwyn
陈功友	badc
陈小丹	bimy
陈小波	biih
陈昌根	bjsv
陈玲玲	bggw
陈鸿雁	bidw
陈鹏辉	beig
陪着你	buwq
陶渊明	bije
陶维星	bxjt
霍晶晶	fjjj
靳筱勇	atce
韩东日	fada
项晓烘	ajoa
预处理	ctgj
饿了么	qbtc
马利云	ctfc
马宗伟	cpwf
马雪琼	cfgy
骑回去	clfc
高世超	yafh
高秀卿	ytqt
高雅丽	yagm
魏巧莲	taal
魏巧莲	taal
魏青春	tgdw
鱼豆腐	qgow
鸡蛋清	cnig
鸡蛋黄	cnam
黄日辉	adig
黄曦漫	ajij
黄鹤楼	apso
黎俊禹	twtk
黎孝全	tfwg
黎明亦	tjyo
黑暗中	ljkh
鼠须管	eetp
鼠须管	eetp
一个星期	gwja
一键锁屏	gqqn
两城一家	gfgp
中国移动	kltf
中通快递	kcnu
京东快递	yanu
人外有人	wqdw
代谢通路	wyck
代谢通路	wyck
兼容模式	upsa
分析化学	wswi
办公软件	ewlw
各种各样	ttts
团体活动	lwif
圆通快递	lcnu
处理数据	tgor
天天向上	ggth
天天快递	ggnu
学习部长	inut
安装步骤	puhc
客座学生	poit
小米系统	iotx
山东卫视	mabp
山外有山	mqdm
康明眼镜	ojhq
延大信件	tdww
延大邮政	tdmg
延边大学	tedi
延边美食	teuw
当前目录	iuhv
微生物学	ttti
我的电脑	trje
控制面板	rrds
智能公交	tcwy
最强大脑	jxde
有道词典	duym
极速模式	sgsa
武汉大学	fidi
测试中心	iykn
玛丽蛋糕	ggno
现场直播	gffr
生日快乐	tdnt
生物化学	ttwi
申通快递	jcnu
百度公交	dowy
百度地图	dofl
相互作用	sgwe
石锅拌饭	dqrq
石锅拌饭	dqrq
科技大厦	trdd
移动公司	tfwn
站长工具	utah
竞争关系	uqut
自强学堂	txii
自强学堂	txii
自相矛盾	tscr
蚂蚁花呗	jjak
西南大学	sfdi
轻而易举	ldji
长江大桥	tids
非常假期	hiwa
顺丰快递	kdnu
馨园山庄	flmo
驾照宝典	ejpm
高德地图	ytfl
中国好声音	klvu
