孙畅	bijh
卢方	hnyy
刑佳钰	gwqg
刘倩	yjwg
刘凤娇	ywvt
刘双	yjcc
丁兵兵	srrg
丁国翠	slny
丁煜倬	sowh
丁邵珍	svgw
丁雪	sgfv
万丹	gqmy
付丹丹	wmmy
付名扬	wqrn
付智仲	wtwk
任志强	wfxk
任梦梦	wsss
何玉贤	wgjc
余伟江	wwia
余舒琪	wwga
余鹏鹏	weee
侯晓沛	wjig
冯世伦	uaww
冯世兴	uaig
冯敏	uctx
冯盼	uchw
凌旭	ufvj
刘义胜	yyet
刘君	yjvt
刘嘉睿	yfhp
刘天罡	yglg
刘婷婷	yvvy
刘家春	ypdw
刘家民	ypna
刘影	yjjy
刘琛	yjgp
刘聪	yjbu
刘艳萍	ydai
刘辉	yjig
刘进	yjfj
刘鑫	yjqq
刘飞	yjnu
刘香	yjtj
包翠香	qntj
单田芳	ulay
南宗焕	fpoq
卢盈旋	hbyt
卢超	hnfh
历小丹	dimy
原瑞凯	dgmn
史敦海	kyit
叶青林	kgss
向倩榕	twsp
向曙光	tjig
向芳	tmay
吕惠子	kgbb
吕振斌	kryf
吕文兴	kyig
吴丹	kgmy
吴凤意	kwuj
吴师文	kjyy
吴玉兰	kgud
吴玲	kggw
吴知非	kthd
吴蕊	kgan
吴鑫	kgqq
周婷兰	mvud
周尤涛	mdid
周海庆	miod
周羽	mfnn
周自平	mtgu
周轶	mflr
周高	mfyk
唐为	ovyt
唐保志	owfn
唐永林	oyss
唐永虎	oyha
夏凯丽	dmgm
夏思宇	dlpg
夏桂权	dssc
姚鹏飞	venu
姜程	ugtk
娄兰兰	ouud
娄权利	ostj
孙卫平	bbgu
孙宇辉	bpig
孙文婷	byvy
孙文超	byfh
孙良鹏	byee
孙金凤	bqwc
孙雪	bifv
孟会影	bwjy
安英珍	pagw
宋雪萍	pfai
官绪超	pxfh
宿子瑶	pbge
尹丽丽	vggm
岑毅虹	muja
崔宝	mwpg
崔斌	mwyf
崔瑜娜	mgvn
崔银姬	mqva
崔龙成	mddn
康凯	ovmn
廖雪峰	ofmt
张丽	xtgm
张云	xtfc
张亚楠	xgsf
张俊	xtwc
张卓	xthj
张天丽	xggm
张娟	xtvk
张婵	xtvu
张宇宁	xpps
张宇琛	xpgp
张宗运	xpfc
张帅军	xjpl
张庆涛	xoid
张建军	xvpl
张强	xtxk
张德全	xtwg
张志波	xfih
张思龙	xldx
张文慧	xydh
张旭	xtvj
张晓波	xjih
张有亲	xdus
张松山	xsmm
张浩然	xiqd
张源	xtid
张溪	xtie
张玉静	xgge
张琪	xtga
张皓然	xrqd
张硕	xtdd
张紫鑫	xhqq
张红霞	xxfn
张维伯	xxwr
张艳	xtdh
张蕊	xtan
张钊	xtqj
张钰京	xqyk
张雨	xtfg
张龙	xtdx
彭业成	fodn
彭洪才	fift
彭海东	fiai
彭琼玲	fggw
彭辉	fkig
徐明	twje
徐春光	tdig
徐润生	titg
文元西	yfsg
文师师	yjjg
方文山	yymm
易善勇	juce
易善德	jutf
易善维	juxw
易培松	jfsw
易明双	jjcc
易浩	jqit
易海祯	jipy
易老师	jfjg
曹小文	giyy
曹晓璇	gjgy
曹桂领	gswy
曹硕	gmdd
曹祎卉	gpfa
曾哥	ulsk
曾宪刚	upmr
曾虎	ulha
曾龙龙	uddx
朱乾荣	rfap
朱倩倩	rwwg
朱贺	riek
朱露	rifk
朴光哲	sirr
朴曙东	sjai
朴海媛	sive
朴海星	sijt
李丹艳	smdh
李亚茹	sgav
李光辉	siig
李兴会	siwf
李勇健	scwv
李华清	swig
李园丽	slgm
李夏	sbdh
李娜	sbvn
李婷	sbvy
李媛媛	svve
李建	sbvg
李建鑫	svqq
李彩宾	sepr
李征远	stfq
李志勇	sfce
李愉晨	snjd
李拼	sbru
李文	sbyy
李方	sbyy
李明星	sjjt
李明洙	sjir
李昱	sbju
李晓珍	sjgw
李曹	sbgm
李楠	sbsf
李海静	sige
李渊	sbit
李燕	sbak
李燕飞	sanu
李琪琛	sggp
李胜青	sege
李花淑	saih
李苗苗	saal
李莲花	saaw
李萌萌	saaj
李言	sbyy
李辉	sbig
李银姬	sqva
李阳阳	sbbj
李霖	sbfs
李顺治	skic
李鹏飞	senu
李龙	sbdx
杨世凯	samn
杨凯婷	smvy
杨啸	snkv
杨小燕	siak
杨春丽	sdgm
杨梦	snss
杨欢	sncq
杨艳召	sdvk
杨贺然	seqd
杨鑫	snqq
林羽湉	snin
林雨湉	sfin
柳叶茂	skad
柳海燕	siak
梁家兴	ipig
武晓琳	fjgs
段贵批	wkrx
段越敏	wftx
段雪健	wfwv
殷如	rvvk
江涛	iaid
池淏甜	iitd
池金花	iqaw
汪亮	igyk
汪倩倩	iwwg
汪志桥	ifst
沈世信	iawy
河健	iswv
涂伟忠	iwkh
涂培勇	ifce
涂培红	ifxa
涂太保	idwk
涂太平	idgu
涂安忠	ipkh
涂建功	ivae
涂敏	iwtx
涂敦平	iygu
涂敦民	iyna
涂新	iwus
涂玲	iwgw
涂琴	iwgg
涂登元	iwfq
涂继忠	ixkh
涂贵荣	ikap
涂超	iwfh
温夏夏	iddh
滕梓臣	esah
潘福军	ippl
潘诗逸	iyqk
熊彬彬	csss
熊念山	cwmm
王丽丽	gggm
王乐乐	gttn
王亚娟	ggvk
王亚蓉	ggap
王伟伟	gwwf
王冬雪	gtfv
王凯	ggmn
王剑坤	gwfj
王加丽	gegm
王卢莎	ghai
王哲	ggrr
王国海	glit
王天阳	ggbj
王婷	ggvy
王婷婷	gvvy
王嫒嫡	gvvy
王嫡	ggvy
王官正	gpgh
王建朝	gvfj
王微	ggtm
王志强	gfxk
王忠骞	gkpa
王恩民	glna
王才华	gfwx
王振亚	grgo
王晓丹	gjmy
王曼	ggjl
王有为	gdyt
王洪鸣	gikq
王涛	ggid
王淇漫	giij
王爱荣	geap
王爽	ggdr
王玉江	ggia
王田田	glll
王红妮	gxvn
王超	ggfh
王轶宙	glpm
王闪	gguw
王雪	ggfv
王顺超	gkfh
王鹏宇	gepg
田波	llih
田玉顺	lgkd
田雪	llfv
白壹鹏	rfee
白小龙	ridx
白洋	rriu
白爽	rrdr
盛倩文	dwyy
祁建钊	pvqj
秦亚红	dgxa
秦智亮	dtyk
程功平	tagu
程周	tkmf
程哥	tksk
程明	tkje
程晓燕	tjak
穆冠桥	tpst
纪楠	xnsf
续广娟	xovk
罗吉芳	lfay
罗容君	lpvt
罗惠善	lgug
罗陈	lqba
耿文静	byge
肖丽萍	igai
胡伟	dewf
胡宇浩	dpit
胡翠苹	dnag
胡老师	dfjg
胡黔楠	dlsf
舒兵	wfrg
范德华	atwx
荣玉	apgy
葛元洁	afif
董媛	atve
薛娇	awvt
虞诗诚	hyyd
袁乐	fktn
袁帅芳	fjay
袁淑华	fiwx
袁艳平	fdgu
解秋芳	qtay
许仁政	ywgh
许佳佳	ywwf
许小文	yiyy
许立志	yufn
谈弋	yoay
谢剑梅	ywst
谢周凡	ymwy
谢艳蕾	ydaf
谢顺岚	ykmw
谭阳	ysbj
贾晓歌	sjsk
赖崇德	gmtf
赵俊凤	fwwc
赵兴月	fiee
赵潇溟	fiip
车伟健	lwwv
车通	lgce
迟美娇	nuvt
邓喆	cbfk
邓文文	cyyy
邓莎莎	caai
邢肖兰	giud
邹佳丽	qwgm
邹李	qvsb
郑兴	udig
郑华	udwx
郑学兰	uiud
郑明善	ujug
郑春明	udje
郑艳	uddh
郭衍良	ytyv
郭超	ykfh
金丽丽	qggm
金丽华	qgwx
金光洙	qiir
金光浩	qiit
金妍	qqvg
金日	qqjj
金晟宇	qjpg
金海旭	qivj
金玉善	qgug
金练文	qxyy
金美娜	quvn
金老师	qfjg
金香子	qtbb
钟大猷	qdus
钱兵兵	qrrg
门秋序	utoc
闫秋瑾	utga
阮一峰	bgmt
阮昌应	bjoi
陈丽华	bgwx
陈伟	bawf
陈佳欢	bwcq
陈全永	bwyn
陈功友	badc
陈小丹	bimy
陈小波	biih
陈康	baov
陈惠	bagj
陈昌根	bjsv
陈栋	basa
陈浩	bait
陈涛	baid
陈玲玲	bggw
陈群	bavt
陈虎	baha
陈进	bafj
陈鸿雁	bidw
陈鹏辉	beig
陶慧	bqdh
陶渊明	bije
陶维星	bxjt
霍晶晶	fjjj
靳筱勇	atce
韩东日	fajj
韩晶	fjjj
韩玲	fjgw
韩莹	fjap
项晓烘	ajoa
马利云	ctfc
马宗伟	cpwf
马雪琼	cfgy
马飞	cgnu
高世超	yafh
高秀卿	ytqt
高阳	ykbj
高雅丽	yagm
魏巧莲	taal
魏青春	tgdw
鲍悦	qgnu
黄曦漫	ajij
黄杰	amso
黄荣	amap
黄蓉	amap
黄靖	amug
黎俊禹	twtk
黎孝全	tfwg
黎寒	tqpa
黎明亦	tjyo
